18 18 18 18 18 18 18 18 18 18 18 18 18 18 18 18 18 18 18 18 18 18 18 18 18 18 18 18 18 18 18 18 18 18 18 18 18 18 18 18 18 18 18 18 18 18 18 18 18 18 18 18 18 18 18 18 18 18 18 18 18 18 18 18 18 18 18 18 18 18 18 18 18 18 18 18 18 18 18 18 18 18 18 18 18 18 18 18 18 18 18 18 18 18 18 18 18 18 18 18 
18 18 18 18 18 18 18 18 18 18 18 18 18 18 18 18 18 18 18 18 18 18 18 18 18 18 18 18 18 18 18 18 18 18 18 18 18 18 18 18 18 18 18 18 18 18 18 18 18 18 18 18 18 18 18 18 18 18 18 18 18 18 18 18 18 18 18 18 18 18 18 18 18 18 18 18 18 18 18 18 18 18 18 18 18 18 18 18 18 18 18 18 18 18 18 18 18 18 18 18 
18 18 18 18 18 18 18 18 18 18 18 18 18 18 18 18 18 18 18 18 18 18 18 18 18 18 18 18 18 18 18 18 18 18 18 18 18 18 18 18 18 18 18 18 18 18 18 18 18 18 18 18 18 18 18 18 18 18 18 18 18 18 18 18 18 18 18 18 18 18 18 18 18 18 18 18 18 18 18 18 18 18 18 18 18 18 18 18 18 18 18 18 18 18 18 18 18 18 18 18 
18 18 18 18 18 18 18 18 18 18 18 18 18 18 18 18 18 18 18 18 18 18 18 18 18 18 18 18 18 18 18 18 18 18 18 18 18 18 18 18 18 18 18 18 18 18 18 18 18 18 18 18 18 18 18 18 18 18 18 18 18 18 18 18 18 18 18 18 18 18 18 18 18 18 18 18 18 18 18 18 18 18 18 18 18 18 18 18 18 18 18 18 18 18 18 18 18 18 18 18 
18 18 18 18 18 18 18 18 18 18 18 18 18 18 18 18 18 18 18 18 18 18 18 18 18 18 18 18 18 18 18 18 18 18 18 18 18 18 18 18 18 18 18 18 18 18 18 18 18 18 18 18 18 18 18 18 18 18 18 18 18 18 18 18 18 18 18 18 18 18 18 18 18 18 18 18 18 18 18 18 18 18 18 18 18 18 18 18 18 18 18 18 18 18 18 18 18 18 18 18 
18 18 18 18 18 18 18 18 18 18 18 18 18 18 18 18 18 18 18 18 18 18 18 18 18 18 18 18 18 18 18 18 18 18 18 18 18 18 18 18 18 18 18 18 18 18 18 18 18 18 18 18 18 18 18 18 18 18 18 18 18 18 18 18 18 18 18 18 18 18 18 18 18 18 18 18 18 18 18 18 18 18 18 18 18 18 18 18 18 18 18 18 18 18 18 18 18 18 18 18 
18 18 18 18 18 18 18 18 18 18 18 18 18 18 18 18 18 18 18 18 18 18 18 18 18 18 18 18 18 18 18 18 18 18 18 18 18 18 18 18 18 18 18 18 18 18 18 18 18 18 18 18 18 18 18 18 18 18 18 18 18 18 18 18 18 18 18 18 18 18 18 18 18 18 18 18 18 18 18 18 18 18 18 18 18 18 18 18 18 18 18 18 18 18 18 18 18 18 18 18 
18 18 18 18 18 18 18 18 18 18 18 18 18 18 18 18 18 18 18 18 18 18 18 18 18 18 18 18 18 18 18 18 18 18 18 18 18 18 18 18 18 18 18 18 18 18 18 18 18 18 18 18 18 18 18 18 18 18 18 18 18 18 18 18 18 18 18 18 18 18 18 18 18 18 18 18 18 18 18 18 18 18 18 18 18 18 18 18 18 18 18 18 18 18 18 18 18 18 18 18 
18 18 18 18 18 18 18 18 18 18 18 18 18 18 18 18 18 18 18 18 18 18 18 18 18 18 18 18 18 18 18 18 18 18 18 18 18 18 18 18 18 18 18 18 18 18 18 18 18 28 26 26 26 26 26 26 26 26 26 26 26 26 26 26 26 26 26 26 26 26 26 26 26 26 26 26 26 26 29 18 18 18 18 18 18 18 18 18 18 18 18 18 18 18 18 18 18 18 18 18 
18 18 18 18 18 18 18 18 18 18 18 18 18 18 18 18 18 18 18 18 18 18 18 18 18 18 18 18 18 18 18 18 18 18 18 18 18 18 18 18 18 18 18 18 18 18 18 18 18 24 32 32 32 32 32 32 32 32 32 32 32 32 32 32 32 32 32 32 32 32 32 32 32 32 32 32 32 32 25 26 26 26 29 18 18 18 18 18 18 18 18 18 18 18 18 18 18 18 18 18 
18 18 18 18 18 18 18 18 18 18 18 18 18 18 18 18 18 18 18 18 18 18 18 18 18 18 18 18 18 18 18 18 18 18 18 18 18 18 18 18 18 18 18 18 18 18 18 18 18 24 32 17 17 17 17 17 17 17 17 17 17 17 17 17 17 17 17 17 17 17 17 17 17 17 17 17 17 32 16 16 16 16 23 18 18 18 18 18 18 18 18 18 18 18 18 18 18 18 18 18 
18 18 18 18 18 18 18 18 18 18 18 18 18 18 18 18 18 18 18 18 18 18 18 18 18 18 18 18 18 18 18 18 18 18 18 18 18 18 18 18 18 18 18 18 18 18 18 18 18 24 32 17 17 17 17 17 17 17 17 17 17 17 17 17 17 17 17 17 17 17 17 17 17 17 17 17 17 32 16 1 16 16 23 18 18 18 18 18 18 18 18 18 18 18 18 18 18 18 18 18 
18 18 18 18 18 18 18 18 18 18 18 18 18 18 18 18 18 18 18 18 18 18 18 18 18 18 18 18 18 18 18 18 18 18 18 18 18 18 18 18 18 18 18 18 18 18 18 18 18 24 32 17 17 17 17 17 17 17 17 17 17 17 17 17 17 17 17 17 17 17 17 17 17 17 17 17 17 32 1 1 16 16 23 18 18 18 18 18 18 18 18 18 18 18 18 18 18 18 18 18 
18 18 18 18 18 18 18 18 18 18 18 18 18 18 18 18 18 18 18 18 18 18 18 18 18 18 18 18 18 18 18 18 18 18 18 18 18 18 18 18 18 18 18 18 18 18 18 18 18 24 32 17 17 17 17 17 17 17 17 17 17 17 17 17 17 17 17 17 17 17 17 17 17 17 17 17 17 32 1 1 16 16 23 18 18 18 18 18 18 18 18 18 18 18 18 18 18 18 18 18 
18 18 18 18 18 18 18 18 18 18 18 18 18 18 18 18 18 18 18 18 18 18 18 18 18 18 18 18 18 18 18 18 18 18 18 18 18 18 18 18 18 18 18 18 18 18 18 18 18 24 32 17 17 17 17 17 17 17 17 17 17 17 17 17 17 17 17 17 17 17 17 17 17 17 17 17 17 32 1 1 1 16 23 18 18 18 18 18 18 18 18 18 18 18 18 18 18 18 18 18 
18 18 18 18 18 18 18 18 18 18 18 18 18 18 18 18 18 18 18 18 18 18 18 18 18 18 18 18 18 18 18 18 18 18 18 18 18 18 18 18 18 18 18 18 18 18 18 18 18 24 32 17 17 17 17 17 17 17 17 17 17 17 17 17 17 17 17 17 17 17 17 17 17 17 17 17 17 32 1 1 1 1 23 18 18 18 18 18 18 18 18 18 18 18 18 18 18 18 18 18 
18 18 18 18 18 18 18 18 18 18 18 18 18 18 18 18 18 18 18 18 18 18 18 18 18 18 18 18 18 28 26 26 26 26 26 26 26 26 26 26 26 26 26 26 26 26 29 18 18 24 32 17 17 17 17 17 17 17 17 17 17 17 17 17 17 17 17 17 17 17 17 17 17 17 17 17 17 32 1 1 1 1 23 18 18 18 18 18 18 18 18 18 18 18 18 18 18 18 18 18 
18 18 18 18 18 18 18 18 18 18 18 18 18 18 18 18 18 18 18 18 18 18 18 18 18 18 18 18 18 24 1 16 1 1 1 1 1 1 1 1 1 1 16 1 1 1 23 18 18 24 32 32 32 17 17 17 17 17 17 17 17 17 17 17 17 17 17 17 17 17 17 17 17 17 17 17 17 32 1 1 1 1 23 18 18 18 18 18 18 18 18 18 18 18 18 18 18 18 18 18 
18 18 18 18 18 18 18 18 18 18 18 18 18 28 26 26 26 26 26 26 26 26 26 26 26 26 26 26 26 27 1 1 1 1 1 1 16 1 1 1 1 1 1 1 1 1 23 18 18 30 21 22 32 17 17 17 17 17 17 17 17 17 17 17 17 17 17 17 17 17 17 17 17 17 17 17 17 32 1 1 1 1 23 18 18 18 18 18 18 18 18 18 18 18 18 18 18 18 18 18 
18 18 18 18 18 18 18 18 18 18 18 18 18 24 1 1 1 1 1 1 1 1 1 1 1 12 10 10 10 10 10 10 10 10 10 10 10 10 10 10 10 10 10 13 1 1 23 18 18 18 18 24 32 17 17 17 17 17 17 17 17 17 17 17 17 17 17 17 17 17 17 17 17 17 17 17 17 32 1 1 1 1 23 18 18 18 18 18 18 18 18 18 18 18 18 18 18 18 18 18 
18 18 18 18 18 18 18 18 18 18 18 18 18 24 1 16 1 1 1 1 1 1 1 1 1 8 3 3 3 3 3 3 3 3 3 3 3 3 3 3 3 3 3 7 1 1 23 18 18 18 18 24 32 17 17 17 17 17 17 17 17 17 17 17 17 17 17 17 17 17 17 17 17 17 17 17 17 32 1 1 1 1 23 18 18 18 18 18 18 18 18 18 18 18 18 18 18 18 18 18 
18 18 18 18 18 18 18 18 18 18 18 18 18 24 1 1 1 1 1 1 1 16 1 1 1 8 3 4 5 5 5 5 5 5 5 5 5 5 5 5 5 5 5 15 1 1 23 18 18 18 18 24 32 17 17 17 17 17 17 17 17 17 17 17 17 17 17 17 17 17 17 17 17 17 17 17 17 32 1 1 16 1 23 18 18 18 18 18 18 18 18 18 18 18 18 18 18 18 18 18 
18 18 18 18 18 18 18 18 18 18 18 18 18 24 1 1 1 1 1 1 1 1 1 1 1 8 3 7 1 1 1 1 1 1 1 1 1 1 1 1 1 1 1 1 16 1 23 18 18 18 18 24 32 17 17 17 17 17 17 17 17 17 17 17 17 17 17 17 17 17 17 17 17 17 17 17 17 32 1 1 1 1 23 18 18 18 18 18 18 18 18 18 18 18 18 18 18 18 18 18 
18 18 18 18 18 18 18 18 18 18 18 18 18 24 1 1 1 1 1 1 1 1 1 1 1 8 3 7 1 1 1 1 1 1 16 1 1 1 1 1 1 16 1 1 1 1 23 18 18 18 18 24 32 17 17 17 17 17 17 17 17 17 17 17 17 17 17 17 17 17 17 17 17 17 17 17 17 32 1 16 1 1 23 18 18 18 18 18 18 18 18 18 18 18 18 18 18 18 18 18 
18 18 18 18 18 18 18 18 18 18 18 18 18 24 1 1 1 1 16 1 1 1 1 1 1 8 3 7 1 1 1 1 1 1 1 1 1 1 1 1 1 1 1 1 1 1 23 18 18 18 18 24 32 17 17 17 17 17 17 17 17 17 17 17 17 17 17 17 17 17 17 17 17 17 17 17 17 32 1 1 1 1 23 18 18 18 18 18 18 18 18 18 18 18 18 18 18 18 18 18 
18 18 18 18 18 18 18 18 18 18 18 18 18 24 1 1 1 1 1 1 1 1 1 1 1 8 3 7 16 16 1 1 1 1 1 1 1 1 1 1 1 1 1 1 1 1 23 18 18 18 18 24 32 17 17 17 17 17 17 17 17 17 17 17 17 17 17 17 17 17 17 17 17 17 17 17 17 32 16 1 1 16 23 18 18 18 18 18 18 18 18 18 18 18 18 18 18 18 18 18 
18 18 18 18 18 18 18 18 18 18 18 18 18 24 1 1 1 1 1 1 1 1 1 1 1 8 3 7 16 1 16 16 1 1 1 1 1 1 1 1 1 1 1 1 1 1 23 18 18 18 18 24 32 32 32 32 32 32 32 32 32 32 32 17 17 17 17 17 17 17 17 17 17 17 17 17 17 32 1 1 1 1 23 18 18 18 18 18 18 18 18 18 18 18 18 18 18 18 18 18 
18 18 18 18 18 18 18 18 18 18 18 18 18 24 1 16 1 1 1 1 1 1 1 1 16 8 3 7 16 16 16 1 1 16 1 1 1 1 1 1 1 1 1 1 1 1 23 18 18 18 18 30 21 21 21 21 21 21 21 21 21 22 32 17 17 17 17 17 17 17 17 17 17 17 17 17 17 32 1 1 1 1 23 18 18 18 18 18 18 18 18 18 18 18 18 18 18 18 18 18 
18 18 18 18 18 18 18 18 18 18 18 18 18 24 1 1 1 1 1 16 1 1 1 1 1 8 3 7 16 16 1 1 1 1 1 1 1 1 16 1 1 1 1 1 1 1 23 18 18 18 18 18 18 18 18 18 18 18 18 18 18 24 32 17 17 17 17 17 17 17 17 17 17 17 17 17 17 32 1 16 1 1 23 18 18 18 18 18 18 18 18 18 18 18 18 18 18 18 18 18 
18 18 18 18 18 18 18 18 18 18 18 18 18 24 1 12 10 10 10 10 10 10 10 10 10 11 3 9 10 10 10 10 10 10 10 10 10 10 10 10 10 10 10 10 10 13 23 18 18 18 18 18 18 18 18 18 18 18 18 18 18 24 32 17 17 17 17 17 17 17 17 17 17 17 17 17 17 32 1 1 1 1 23 18 18 18 18 18 18 18 18 18 18 18 18 18 18 18 18 18 
18 18 18 18 18 18 18 18 18 18 18 18 18 24 1 8 3 3 3 3 3 3 3 3 3 3 3 3 3 3 3 3 3 3 3 3 3 3 3 3 3 3 3 3 3 7 23 18 18 18 18 18 18 18 18 18 18 18 18 18 18 24 32 17 17 17 17 17 17 17 17 17 17 17 17 17 17 32 1 1 1 1 23 18 18 18 18 18 18 18 18 18 18 18 18 18 18 18 18 18 
18 18 18 18 18 18 18 18 18 18 18 18 18 24 1 14 5 5 5 5 5 5 5 5 5 6 3 4 5 5 5 5 5 5 5 5 5 6 3 4 5 5 5 5 5 15 23 18 18 18 18 18 18 18 18 18 18 18 18 18 18 24 32 17 17 17 17 17 17 17 17 17 17 17 17 17 17 32 1 1 1 1 23 18 18 18 18 18 18 18 18 18 18 18 18 18 18 18 18 18 
18 18 18 18 18 18 18 18 18 18 18 18 18 24 1 1 1 1 1 1 16 16 16 1 1 8 3 7 1 1 1 1 1 1 1 1 1 8 3 7 1 1 1 1 1 1 23 18 18 18 18 18 18 18 18 18 18 18 18 18 18 24 32 32 32 32 32 32 32 32 32 17 17 17 17 17 17 32 1 1 1 16 23 18 18 18 18 18 18 18 18 18 18 18 18 18 18 18 18 18 
18 18 18 18 18 18 18 18 18 18 18 18 18 24 1 1 1 1 1 1 16 16 16 16 16 8 3 7 1 16 1 1 1 16 1 1 1 8 3 7 1 1 1 1 1 1 23 18 18 18 18 18 18 18 18 18 18 18 18 18 18 30 21 21 21 21 21 21 21 22 32 17 17 17 17 17 17 32 1 1 1 1 23 18 18 18 18 18 18 18 18 18 18 18 18 18 18 18 18 18 
18 18 18 18 18 18 18 18 18 18 18 18 18 24 1 1 1 1 1 1 16 16 1 16 1 8 3 7 1 16 16 16 16 16 16 1 1 8 3 7 1 1 1 1 16 16 23 18 18 18 18 18 18 18 18 18 18 18 18 18 18 18 18 18 18 18 18 18 18 24 32 17 17 17 17 17 17 32 1 16 1 1 23 18 18 18 18 18 18 18 18 18 18 18 18 18 18 18 18 18 
18 18 18 18 18 18 18 18 18 18 18 18 18 24 1 1 1 1 1 1 1 1 16 16 16 8 3 7 1 16 16 16 16 16 16 1 1 8 3 7 1 1 1 1 16 16 25 26 26 26 26 26 26 26 26 26 26 26 26 26 29 18 18 18 18 18 18 18 18 24 32 17 17 17 17 17 17 32 1 1 1 1 23 18 18 18 18 18 18 18 18 18 18 18 18 18 18 18 18 18 
18 18 18 18 18 18 18 18 18 18 18 18 18 24 1 1 1 16 1 1 1 1 1 1 1 8 3 7 1 1 16 1 1 16 16 16 1 14 5 15 1 1 1 1 16 16 16 16 16 1 1 1 1 16 16 16 16 16 16 16 23 18 18 18 18 18 18 18 18 24 32 32 32 17 32 32 32 32 1 1 1 16 23 18 18 18 18 18 18 18 18 18 18 18 18 18 18 18 18 18 
18 18 18 18 18 18 18 18 18 18 18 18 18 24 1 1 1 1 1 1 1 1 1 1 1 8 3 7 1 1 1 1 1 1 16 1 1 1 1 1 1 1 1 1 16 16 16 16 16 1 1 1 2 1 1 12 10 13 16 16 23 18 18 18 18 18 18 18 18 24 16 1 1 1 1 1 1 16 16 1 1 2 23 18 18 18 18 18 18 18 18 18 18 18 18 18 18 18 18 18 
18 18 18 18 18 18 18 18 18 18 18 18 18 24 1 1 1 1 1 1 1 1 1 1 1 8 3 7 1 1 1 1 1 16 16 1 1 1 1 1 1 1 1 1 16 16 16 1 1 1 2 1 1 1 2 8 3 7 16 16 23 18 18 18 18 18 18 18 18 24 16 1 1 1 1 1 16 16 16 16 1 1 23 18 18 18 18 18 18 18 18 18 18 18 18 18 18 18 18 18 
18 18 18 18 18 18 18 18 18 18 18 18 18 24 1 1 1 1 1 1 1 1 1 1 1 8 3 7 1 1 16 1 1 1 16 1 1 1 1 1 1 1 1 16 16 16 16 1 1 1 1 1 1 16 1 8 3 7 1 1 23 18 18 18 18 18 18 18 18 24 16 1 1 1 1 1 16 16 16 16 1 1 23 18 18 18 18 18 18 18 18 18 18 18 18 18 18 18 18 18 
18 18 18 18 18 18 18 18 18 18 18 18 18 24 1 1 1 1 1 1 1 1 1 1 1 8 3 7 1 1 1 1 1 1 16 16 1 1 1 1 1 1 1 16 16 16 16 1 1 2 1 1 16 1 16 8 3 7 1 1 23 18 18 18 18 18 18 18 18 24 16 1 1 1 1 1 16 16 1 1 1 1 23 18 18 18 18 18 18 18 18 18 18 18 18 18 18 18 18 18 
18 18 18 18 18 18 18 18 18 18 18 18 18 24 16 16 1 1 1 1 1 1 1 1 1 8 3 7 1 1 1 1 1 1 16 16 1 1 16 1 16 16 1 16 16 16 16 1 1 1 1 1 1 1 1 8 3 7 1 1 23 18 18 18 18 18 18 18 18 24 16 16 16 16 1 1 1 1 1 1 1 16 23 18 18 18 18 18 18 18 18 18 18 18 18 18 18 18 18 18 
18 18 18 18 18 18 18 18 18 18 18 18 18 24 16 16 16 16 1 1 1 1 1 1 1 8 3 7 1 1 1 1 1 1 16 16 16 16 16 16 20 21 22 16 16 1 1 1 1 1 1 1 1 16 1 8 3 7 1 1 23 18 18 18 18 18 18 18 18 24 16 16 16 16 16 1 1 1 1 1 16 16 23 18 18 18 18 18 18 18 18 18 18 18 18 18 18 18 18 18 
18 18 18 18 18 18 18 18 18 18 18 18 18 24 16 16 16 16 16 1 1 1 1 1 1 8 3 7 1 1 1 1 1 1 16 16 16 16 1 1 23 18 30 21 22 1 1 1 1 1 1 16 1 1 1 8 3 7 1 1 23 18 18 18 18 18 18 18 18 24 16 16 16 16 16 16 16 16 16 16 16 16 23 18 18 18 18 18 18 18 18 18 18 18 18 18 18 18 18 18 
18 18 18 18 18 18 18 18 18 18 18 18 18 24 16 16 16 16 16 16 1 1 1 1 1 8 3 7 1 1 1 1 1 1 1 16 20 21 21 21 31 18 18 18 24 1 1 1 1 1 1 1 1 1 1 8 3 7 1 1 23 18 18 18 18 18 18 18 18 30 21 21 21 21 21 21 21 21 21 21 21 21 31 18 18 18 18 18 18 18 18 18 18 18 18 18 18 18 18 18 
18 18 18 18 18 18 18 18 18 18 18 18 18 24 1 1 1 16 16 16 16 1 1 1 1 8 3 7 1 1 1 1 1 1 1 20 31 18 28 26 26 26 26 29 30 22 1 1 1 1 16 1 1 1 1 8 3 7 1 1 23 18 18 18 18 18 18 18 18 18 18 18 18 18 18 18 18 18 18 18 18 18 18 18 18 18 18 18 18 18 18 18 18 18 18 18 18 18 18 18 
18 18 18 18 18 18 18 18 18 18 18 18 18 24 1 1 1 16 16 16 1 1 1 1 1 8 3 7 1 1 1 1 1 1 16 23 18 28 27 1 1 16 1 23 18 24 1 1 1 1 16 16 16 1 1 8 3 7 1 1 23 18 18 18 18 18 18 18 18 18 18 18 18 18 18 18 18 18 18 18 18 18 18 18 18 18 18 18 18 18 18 18 18 18 18 18 18 18 18 18 
18 18 18 18 18 18 18 18 18 18 18 18 18 24 1 1 1 1 1 1 1 1 1 1 1 8 3 7 1 1 1 1 1 1 1 23 18 24 1 16 1 16 20 31 28 27 1 1 1 16 16 16 1 16 1 8 3 7 1 1 23 18 18 18 18 18 18 18 18 28 26 26 26 26 26 26 26 26 26 26 26 26 29 18 18 18 18 18 18 18 18 18 18 18 18 18 18 18 18 18 
18 18 18 18 18 18 18 18 18 18 18 18 18 24 16 1 1 12 10 10 10 10 10 10 10 11 3 7 1 1 1 1 1 16 16 25 29 30 21 21 22 1 23 18 24 1 1 1 1 1 1 16 1 1 1 8 3 7 1 1 23 18 18 18 18 18 18 18 18 24 16 16 16 16 1 1 1 1 1 1 1 1 23 18 18 18 18 18 18 18 18 18 18 18 18 18 18 18 18 18 
18 18 18 18 18 18 18 18 18 18 18 18 18 24 16 1 1 8 3 3 3 3 3 3 3 3 3 7 1 16 1 1 16 16 1 16 25 29 18 18 30 21 31 28 27 1 1 1 1 1 1 1 1 1 1 8 3 7 1 1 23 18 18 18 18 18 18 18 18 24 16 16 16 16 1 1 1 1 1 1 1 1 23 18 18 18 18 18 18 18 18 18 18 18 18 18 18 18 18 18 
18 18 18 18 18 18 18 18 18 18 18 18 18 24 16 1 1 8 3 4 5 5 5 5 5 5 5 15 16 1 1 16 16 1 16 16 1 23 28 26 26 29 18 24 1 1 1 1 1 1 1 1 1 1 16 8 3 7 1 1 23 18 18 18 18 18 18 18 18 24 16 16 16 1 1 1 1 1 1 1 16 16 23 18 18 18 18 18 18 18 18 18 18 18 18 18 18 18 18 18 
18 18 18 18 18 18 18 18 18 18 18 18 18 24 16 1 1 8 3 7 16 1 1 1 16 16 16 16 16 16 16 16 16 16 16 16 1 25 27 1 1 25 26 27 1 1 1 1 16 1 1 1 1 1 1 8 3 7 1 1 23 18 18 18 18 18 18 19 18 24 16 16 1 1 1 1 1 1 16 16 16 16 23 18 18 18 18 18 18 18 18 18 18 18 18 18 18 18 18 18 
18 18 18 18 18 18 18 18 18 18 18 18 18 24 16 1 1 8 3 7 16 16 16 16 1 16 16 16 16 16 16 16 16 16 1 16 1 1 1 1 1 1 1 1 1 1 1 1 1 1 1 1 16 1 1 8 3 7 16 1 25 26 26 26 26 26 26 26 26 27 16 1 1 1 1 1 1 1 1 16 16 16 23 18 18 18 18 18 18 18 18 18 18 18 18 18 18 18 18 18 
18 18 18 18 18 18 18 18 18 18 18 18 18 24 16 1 1 8 3 7 16 1 16 16 16 16 1 16 16 16 16 16 16 16 16 1 1 1 1 1 1 1 1 1 1 1 1 1 1 1 1 1 1 1 1 8 3 7 1 1 16 1 1 1 1 16 1 16 16 16 16 1 1 1 1 1 1 1 1 1 16 16 23 18 18 18 18 18 18 18 18 18 18 18 18 18 18 18 18 18 
18 18 18 18 18 18 18 18 18 18 18 18 18 24 16 1 1 8 3 7 1 1 1 1 1 16 16 16 16 1 1 1 1 1 1 12 10 10 10 10 10 10 10 10 10 10 10 10 10 10 10 10 10 10 10 11 3 7 1 1 1 1 1 16 12 10 10 10 10 10 10 10 10 10 10 10 10 10 13 1 1 16 23 18 18 18 18 18 18 18 18 18 18 18 18 18 18 18 18 18 
18 18 18 18 18 18 18 18 18 18 18 18 18 24 16 1 1 8 3 7 1 1 1 1 1 1 16 16 1 1 1 1 1 1 1 8 3 3 3 3 3 3 3 3 3 3 3 3 3 3 3 3 3 3 3 3 3 7 16 1 1 16 1 16 8 3 3 3 3 3 3 3 3 3 3 3 3 3 7 1 1 1 23 18 18 18 18 18 18 18 18 18 18 18 18 18 18 18 18 18 
18 18 18 18 18 18 18 18 18 18 18 18 18 24 16 1 1 8 3 7 1 1 1 1 1 1 1 1 1 1 1 1 1 1 1 8 3 4 5 5 5 5 5 5 5 6 3 4 5 5 5 5 5 5 5 6 3 7 1 1 1 1 1 1 8 3 4 5 5 5 5 5 5 5 5 5 6 3 7 16 16 16 23 18 18 18 18 18 18 18 18 18 18 18 18 18 18 18 18 18 
18 18 18 18 18 18 18 18 18 18 18 18 18 24 16 1 1 8 3 9 10 10 10 10 10 10 10 10 10 10 10 10 10 10 10 11 3 7 1 1 1 1 1 1 1 8 3 7 1 1 1 1 1 16 1 8 3 9 10 10 10 10 10 10 11 3 7 1 1 16 1 1 1 1 1 1 8 3 7 16 16 16 23 18 18 18 18 18 18 18 18 18 18 18 18 18 18 18 18 18 
18 18 18 18 18 18 18 18 18 18 18 18 18 24 16 1 1 8 3 3 3 3 3 3 3 3 3 3 3 3 3 3 3 3 3 3 3 7 1 1 1 1 1 1 1 8 3 7 1 1 1 1 1 1 1 8 3 3 3 3 3 3 3 3 3 3 7 1 1 16 1 1 1 1 1 1 8 3 7 16 16 16 23 18 18 18 18 18 18 18 18 18 18 18 18 18 18 18 18 18 
18 18 18 18 18 18 18 18 18 18 18 18 18 24 16 1 1 14 5 5 5 6 3 4 5 5 5 5 5 5 5 5 5 5 5 5 5 15 1 1 1 1 1 1 1 8 3 7 1 16 1 1 1 1 1 14 5 5 5 5 5 5 5 5 5 5 15 1 16 16 1 1 1 1 1 1 8 3 7 16 16 16 23 18 18 18 18 18 18 18 18 18 18 18 18 18 18 18 18 18 
18 18 18 18 18 18 18 18 18 18 18 18 18 24 16 1 1 1 1 1 1 8 3 7 1 1 1 1 1 1 16 1 1 1 1 1 1 1 1 1 1 1 1 1 1 8 3 7 1 1 1 1 1 1 1 1 16 1 1 1 1 1 1 1 1 1 1 1 16 16 1 1 1 1 1 1 8 3 7 16 16 16 23 18 18 18 18 18 18 18 18 18 18 18 18 18 18 18 18 18 
18 18 18 18 18 18 18 18 18 18 18 18 18 24 16 1 1 1 1 1 1 8 3 7 1 1 1 1 1 16 16 16 16 16 16 16 16 1 1 1 1 1 1 1 1 8 3 7 1 1 1 1 16 1 1 1 1 1 1 1 1 1 1 1 1 1 16 16 16 16 16 16 1 1 1 1 8 3 7 1 16 16 23 18 18 18 18 18 18 18 18 18 18 18 18 18 18 18 18 18 
18 18 18 18 18 18 18 18 18 18 18 18 18 24 16 1 1 1 1 1 1 8 3 9 13 1 1 1 16 16 20 21 21 21 21 22 16 16 16 1 1 1 1 1 1 8 3 7 1 1 1 20 21 21 21 21 21 21 21 21 21 21 21 21 21 21 21 21 21 22 16 16 1 1 1 1 8 3 7 1 1 1 23 18 18 18 18 18 18 18 18 18 18 18 18 18 18 18 18 18 
18 18 18 18 18 18 18 18 18 18 18 18 18 24 16 1 1 1 1 1 1 8 3 3 7 1 1 1 16 16 23 18 18 18 18 24 16 16 16 1 16 16 16 1 1 8 3 7 16 16 16 25 26 26 29 18 18 18 18 18 18 18 18 18 18 18 18 18 18 24 16 16 16 16 1 1 8 3 7 1 1 1 23 18 18 18 18 18 18 18 18 18 18 18 18 18 18 18 18 18 
18 18 18 18 18 18 18 18 18 18 18 18 18 24 16 1 1 1 1 1 1 14 6 3 7 1 1 1 1 16 23 18 18 18 18 30 21 22 16 16 16 16 16 1 1 8 3 7 16 16 16 16 16 16 23 18 18 18 18 18 18 18 18 18 18 18 18 18 18 24 16 16 16 16 1 1 8 3 7 1 1 1 23 18 18 18 18 18 18 18 18 18 18 18 18 18 18 18 18 18 
18 18 18 18 18 18 18 18 18 18 18 18 18 24 16 1 1 1 1 1 1 1 8 3 7 1 1 1 1 16 23 18 18 18 18 18 18 24 16 16 16 16 16 1 1 8 3 7 1 16 16 16 16 16 23 18 18 18 18 18 18 18 18 18 18 18 18 18 18 24 16 16 16 16 16 16 8 3 7 1 1 16 23 18 18 18 18 18 18 18 18 18 18 18 18 18 18 18 18 18 
18 18 18 18 18 18 18 18 18 18 18 18 18 24 16 1 1 1 1 1 1 1 8 3 9 13 1 1 16 16 23 18 18 18 18 18 18 24 16 16 16 16 16 16 16 8 3 7 16 16 16 16 16 16 23 18 18 18 18 18 18 18 18 18 18 18 18 18 18 24 16 16 16 16 16 16 8 3 7 1 16 16 23 18 18 18 18 18 18 18 18 18 18 18 18 18 18 18 18 18 
18 18 18 18 18 18 18 18 18 18 18 18 18 24 16 1 1 1 1 1 1 1 8 3 3 7 1 1 16 16 23 18 18 18 18 18 18 24 16 16 12 10 10 10 10 11 3 7 1 1 1 1 16 16 23 18 18 18 18 18 18 18 18 18 18 18 18 18 18 24 16 16 16 16 16 16 8 3 7 16 16 16 23 18 18 18 18 18 18 18 18 18 18 18 18 18 18 18 18 18 
18 18 18 18 18 18 18 18 18 18 18 18 18 24 16 1 1 1 1 1 1 1 14 6 3 7 1 1 16 16 23 18 18 18 18 18 18 24 16 16 8 3 3 3 3 3 3 7 1 1 1 1 1 16 23 18 18 18 18 18 18 18 18 18 18 18 18 18 18 24 1 1 1 1 1 1 8 3 7 16 16 16 23 18 18 18 18 18 18 18 18 18 18 18 18 18 18 18 18 18 
18 18 18 18 18 18 18 18 18 18 18 18 18 24 16 1 1 1 1 1 1 1 1 8 3 7 1 1 16 16 23 18 18 18 18 18 18 24 16 1 8 3 4 5 5 5 5 15 1 16 16 16 16 16 23 18 18 18 18 18 18 18 18 18 18 18 18 18 18 24 1 1 1 1 1 1 14 5 15 16 16 16 23 18 18 18 18 18 18 18 18 18 18 18 18 18 18 18 18 18 
18 18 18 18 18 18 18 18 18 18 18 18 18 24 16 1 1 1 1 1 1 1 1 8 3 7 1 1 16 1 23 18 18 18 18 18 18 24 1 1 8 3 7 16 16 16 16 16 16 16 16 16 1 16 23 18 18 18 18 18 18 18 18 18 18 18 18 18 18 24 1 1 1 1 1 1 1 1 1 1 1 1 23 18 18 18 18 18 18 18 18 18 18 18 18 18 18 18 18 18 
18 18 18 18 18 18 18 18 18 18 18 18 18 24 16 1 1 1 1 1 1 1 1 8 3 7 1 1 1 1 23 18 18 18 18 18 18 24 1 1 8 3 9 10 10 10 10 10 10 10 10 10 13 1 23 18 18 18 18 18 18 18 18 18 18 18 18 18 18 24 16 16 16 16 16 16 16 16 16 1 1 1 23 18 18 18 18 18 18 18 18 18 18 18 18 18 18 18 18 18 
18 18 18 18 18 18 18 18 18 18 18 18 18 24 16 1 1 1 1 1 1 12 10 11 3 7 1 1 1 1 23 18 18 18 18 18 18 24 1 1 8 3 3 3 3 3 3 3 3 3 3 3 7 1 23 18 18 18 18 18 18 18 18 18 18 18 18 18 18 24 16 16 1 1 1 1 1 1 16 1 1 1 23 18 18 18 18 18 18 18 18 18 18 18 18 18 18 18 18 18 
18 18 18 18 18 18 18 18 18 18 18 18 18 24 16 1 1 1 1 1 1 8 3 3 3 7 1 1 1 1 23 18 18 18 18 18 18 24 1 1 14 5 5 5 5 5 5 5 5 5 6 3 7 1 23 18 18 18 18 18 18 18 18 18 18 18 18 18 18 24 16 16 1 1 1 1 1 1 16 1 1 1 23 18 18 18 18 18 18 18 18 18 18 18 18 18 18 18 18 18 
18 18 18 18 18 18 18 18 18 18 18 18 18 24 16 1 1 1 1 1 1 8 3 4 5 15 1 1 1 1 23 18 18 18 18 18 18 24 1 1 1 1 1 1 1 16 16 1 1 1 8 3 7 1 23 18 18 18 18 18 18 18 18 18 18 18 18 18 18 24 1 1 1 1 1 1 1 1 16 1 1 1 23 18 18 18 18 18 18 18 18 18 18 18 18 18 18 18 18 18 
18 18 18 18 18 18 18 18 18 18 18 18 18 24 16 1 1 1 1 1 1 8 3 7 1 1 1 1 1 1 23 18 18 18 18 18 18 24 1 1 1 16 16 16 16 16 16 16 16 16 8 3 7 1 23 18 18 18 18 18 18 18 18 18 18 18 18 18 18 24 1 1 1 1 1 1 1 1 16 1 1 1 23 18 18 18 18 18 18 18 18 18 18 18 18 18 18 18 18 18 
18 18 18 18 18 18 18 18 18 18 18 18 18 24 16 1 1 1 1 1 1 8 3 7 1 1 1 1 1 1 23 18 18 18 18 18 18 24 1 1 16 16 16 12 10 10 10 10 10 10 11 3 7 1 23 18 18 18 18 18 18 18 18 18 18 18 18 18 18 24 16 1 1 1 1 1 16 16 16 1 1 1 23 18 18 18 18 18 18 18 18 18 18 18 18 18 18 18 18 18 
18 18 18 18 18 18 18 18 18 18 18 18 18 24 16 16 1 1 1 1 1 8 3 7 1 1 1 1 1 1 23 18 18 18 18 18 18 24 16 1 16 1 1 8 3 3 3 3 3 3 3 3 7 1 23 18 18 18 18 18 18 18 18 18 18 18 18 18 18 24 16 1 1 1 1 1 1 1 1 1 1 1 23 18 18 18 18 18 18 18 18 18 18 18 18 18 18 18 18 18 
18 18 18 18 18 18 18 18 18 18 18 18 18 24 16 16 1 1 1 16 1 8 3 7 1 1 1 1 1 1 23 18 18 18 18 18 18 24 16 16 16 1 1 8 3 4 5 5 5 5 5 5 15 1 23 18 18 18 18 18 18 18 18 18 18 18 18 18 18 24 16 1 1 1 1 1 1 1 1 1 1 1 23 18 18 18 18 18 18 18 18 18 18 18 18 18 18 18 18 18 
18 18 18 18 18 18 18 18 18 18 18 18 18 24 16 16 1 1 1 1 1 8 3 7 1 1 1 16 1 1 23 18 18 18 18 18 18 24 16 16 16 1 1 8 3 7 1 1 1 1 1 1 1 1 23 18 18 18 18 18 18 18 18 18 18 18 18 18 18 24 16 1 1 1 1 1 16 16 1 1 1 1 23 18 18 18 18 18 18 18 18 18 18 18 18 18 18 18 18 18 
18 18 18 18 18 18 18 18 18 18 18 18 18 24 16 16 1 1 1 1 1 8 3 7 1 1 1 1 1 1 23 18 18 18 18 18 18 24 16 16 1 1 1 8 3 7 1 1 1 1 1 1 1 1 23 18 18 18 18 18 18 18 18 18 18 18 18 18 18 24 16 1 1 1 1 1 16 16 16 16 16 16 23 18 18 18 18 18 18 18 18 18 18 18 18 18 18 18 18 18 
18 18 18 18 18 18 18 18 18 18 18 18 18 24 16 16 1 1 1 1 1 8 3 7 1 1 1 1 1 1 23 18 18 18 18 18 18 24 34 34 34 34 34 34 3 34 34 34 34 34 34 34 34 34 23 18 18 18 18 18 18 18 18 18 18 18 18 18 18 24 16 16 1 1 1 1 16 16 1 1 1 16 23 18 18 18 18 18 18 18 18 18 18 18 18 18 18 18 18 18 
18 18 18 18 18 18 18 18 18 18 18 18 18 24 16 1 1 1 1 1 1 14 5 15 1 1 1 1 1 1 23 18 18 18 18 18 18 24 34 3 3 3 3 3 3 3 3 3 3 3 3 3 3 34 23 18 18 28 26 26 26 26 26 26 26 26 26 26 26 27 16 16 1 1 1 1 1 1 1 1 1 16 23 18 18 18 18 18 18 18 18 18 18 18 18 18 18 18 18 18 
18 18 18 18 18 18 18 18 18 18 18 18 18 24 16 16 1 1 1 16 1 1 1 1 1 1 16 1 1 1 23 18 18 18 18 18 18 24 34 3 3 3 3 3 3 3 3 3 3 3 3 3 3 34 23 18 18 24 16 16 16 16 16 16 16 16 16 16 16 16 16 16 16 16 16 16 16 16 16 16 1 16 23 18 18 18 18 18 18 18 18 18 18 18 18 18 18 18 18 18 
18 18 18 18 18 18 18 18 18 18 18 18 18 24 16 16 1 1 1 1 1 1 1 1 1 1 1 1 1 16 23 18 18 18 18 18 18 24 34 3 3 3 3 3 3 3 3 3 3 3 3 3 3 34 23 18 18 24 16 1 1 1 1 12 10 10 10 10 10 10 10 10 10 10 13 16 16 16 1 1 1 16 23 18 18 18 18 18 18 18 18 18 18 18 18 18 18 18 18 18 
18 18 18 18 18 18 18 18 18 18 18 18 18 24 16 16 1 1 1 1 1 1 1 1 1 1 1 1 1 16 23 18 18 18 18 18 18 24 34 3 3 3 3 3 3 3 3 3 3 3 3 3 3 34 23 18 18 24 16 1 1 16 16 8 3 3 3 3 3 3 3 3 3 3 7 16 16 16 16 1 1 16 23 18 18 18 18 18 18 18 18 18 18 18 18 18 18 18 18 18 
18 18 18 18 18 18 18 18 18 18 18 18 18 24 16 16 1 1 1 1 1 1 1 1 1 16 1 1 1 16 23 18 18 18 18 18 18 24 34 3 3 3 3 3 3 3 3 3 3 3 3 3 3 34 23 18 18 24 16 1 1 16 16 8 3 4 5 5 5 5 5 5 6 3 7 1 16 16 16 1 1 16 23 18 18 18 18 18 18 18 18 18 18 18 18 18 18 18 18 18 
18 18 18 18 18 18 18 18 18 18 18 18 18 24 16 16 1 1 1 1 1 1 1 1 1 1 1 1 1 16 23 18 18 18 18 18 18 24 34 3 3 3 3 3 3 3 3 3 3 3 3 3 3 34 23 18 18 24 16 16 1 16 2 8 3 7 1 16 1 1 16 16 8 3 7 1 16 16 1 1 1 1 23 18 18 18 18 18 18 18 18 18 18 18 18 18 18 18 18 18 
18 18 18 18 18 18 18 18 18 18 18 18 18 24 16 16 1 1 1 1 16 1 1 1 1 1 1 1 1 16 23 18 18 18 18 18 18 24 34 3 3 3 3 3 3 3 3 3 3 3 3 3 3 34 23 18 18 24 16 10 10 10 10 11 3 7 1 16 16 1 1 1 14 5 15 1 16 1 1 1 1 1 23 18 18 18 18 18 18 18 18 18 18 18 18 18 18 18 18 18 
18 18 18 18 18 18 18 18 18 18 18 18 18 24 16 16 1 1 1 1 1 1 1 1 1 1 1 16 16 16 23 18 18 18 18 18 18 24 34 3 3 3 3 3 3 3 3 3 3 3 3 3 3 34 23 18 18 24 16 3 3 3 3 3 3 7 16 16 1 1 1 1 16 16 16 1 1 1 1 1 16 16 23 18 18 18 18 18 18 18 18 18 18 18 18 18 18 18 18 18 
18 18 18 18 18 18 18 18 18 18 18 18 18 24 16 16 16 16 16 16 1 1 16 16 16 16 16 16 16 16 23 18 18 18 18 18 18 24 34 34 34 34 34 34 34 34 34 34 34 34 34 34 34 34 23 18 18 24 16 5 5 5 5 5 5 15 16 16 1 1 1 1 16 16 16 16 1 16 16 16 16 16 23 18 18 18 18 18 18 18 18 18 18 18 18 18 18 18 18 18 
18 18 18 18 18 18 18 18 18 18 18 18 18 30 21 21 21 21 21 21 21 21 21 21 21 21 21 21 21 21 31 18 18 18 18 18 18 30 21 21 21 21 21 21 21 21 21 21 21 21 21 21 21 21 31 18 18 30 21 21 21 21 21 21 21 21 21 21 21 21 21 21 21 21 21 21 21 21 21 21 21 21 31 18 18 18 18 18 18 18 18 18 18 18 18 18 18 18 18 18 
18 18 18 18 18 18 18 18 18 18 18 18 18 18 18 18 18 18 18 18 18 18 18 18 18 18 18 18 18 18 18 18 18 18 18 18 18 18 18 18 18 18 18 18 18 18 18 18 18 18 18 18 18 18 18 18 18 18 18 18 18 18 18 18 18 18 18 18 18 18 18 18 18 18 18 18 18 18 18 18 18 18 18 18 18 18 18 18 18 18 18 18 18 18 18 18 18 18 18 18 
18 18 18 18 18 18 18 18 18 18 18 18 18 18 18 18 18 18 18 18 18 18 18 18 18 18 18 18 18 18 18 18 18 18 18 18 18 18 18 18 18 18 18 18 18 18 18 18 18 18 18 18 18 18 18 18 18 18 18 18 18 18 18 18 18 18 18 18 18 18 18 18 18 18 18 18 18 18 18 18 18 18 18 18 18 18 18 18 18 18 18 18 18 18 18 18 18 18 18 18 
18 18 18 18 18 18 18 18 18 18 18 18 18 18 18 18 18 18 18 18 18 18 18 18 18 18 18 18 18 18 18 18 18 18 18 18 18 18 18 18 18 18 18 18 18 18 18 18 18 18 18 18 18 18 18 18 18 18 18 18 18 18 18 18 18 18 18 18 18 18 18 18 18 18 18 18 18 18 18 18 18 18 18 18 18 18 18 18 18 18 18 18 18 18 18 18 18 18 18 18 
18 18 18 18 18 18 18 18 18 18 18 18 18 18 18 18 18 18 18 18 18 18 18 18 18 18 18 18 18 18 18 18 18 18 18 18 18 18 18 18 18 18 18 18 18 18 18 18 18 18 18 18 18 18 18 18 18 18 18 18 18 18 18 18 18 18 18 18 18 18 18 18 18 18 18 18 18 18 18 18 18 18 18 18 18 18 18 18 18 18 18 18 18 18 18 18 18 18 18 18 
18 18 18 18 18 18 18 18 18 18 18 18 18 18 18 18 18 18 18 18 18 18 18 18 18 18 18 18 18 18 18 18 18 18 18 18 18 18 18 18 18 18 18 18 18 18 18 18 18 18 18 18 18 18 18 18 18 18 18 18 18 18 18 18 18 18 18 18 18 18 18 18 18 18 18 18 18 18 18 18 18 18 18 18 18 18 18 18 18 18 18 18 18 18 18 18 18 18 18 18 
18 18 18 18 18 18 18 18 18 18 18 18 18 18 18 18 18 18 18 18 18 18 18 18 18 18 18 18 18 18 18 18 18 18 18 18 18 18 18 18 18 18 18 18 18 18 18 18 18 18 18 18 18 18 18 18 18 18 18 18 18 18 18 18 18 18 18 18 18 18 18 18 18 18 18 18 18 18 18 18 18 18 18 18 18 18 18 18 18 18 18 18 18 18 18 18 18 18 18 18 
18 18 18 18 18 18 18 18 18 18 18 18 18 18 18 18 18 18 18 18 18 18 18 18 18 18 18 18 18 18 18 18 18 18 18 18 18 18 18 18 18 18 18 18 18 18 18 18 18 18 18 18 18 18 18 18 18 18 18 18 18 18 18 18 18 18 18 18 18 18 18 18 18 18 18 18 18 18 18 18 18 18 18 18 18 18 18 18 18 18 18 18 18 18 18 18 18 18 18 18 
18 18 18 18 18 18 18 18 18 18 18 18 18 18 18 18 18 18 18 18 18 18 18 18 18 18 18 18 18 18 18 18 18 18 18 18 18 18 18 18 18 18 18 18 18 18 18 18 18 18 18 18 18 18 18 18 18 18 18 18 18 18 18 18 18 18 18 18 18 18 18 18 18 18 18 18 18 18 18 18 18 18 18 18 18 18 18 18 18 18 18 18 18 18 18 18 18 18 18 18 
