19 19 19 19 19 19 19 19 19 19 19 19 19 19 19 19 19 19 19 19 19 19 19 19 19 19 19 19 19 19 19 19 19 19 19 19 19 19 19 19 19 19 19 19 19 19 19 19 19 19 
19 19 18 18 18 18 18 18 18 18 18 18 18 18 18 19 19 18 18 18 18 18 18 18 18 18 18 19 19 19 19 19 19 19 18 28 26 26 26 26 26 26 26 26 29 18 18 18 18 19 
19 18 28 26 26 26 26 26 26 26 26 26 26 26 26 26 26 26 26 26 26 26 26 26 26 26 26 26 26 29 19 19 19 19 28 27 1 12 10 10 10 10 16 33 25 26 29 18 18 19 
19 18 24 1 1 16 2 1 16 1 2 1 1 1 1 1 10 10 10 10 16 16 16 16 2 16 2 2 2 23 18 19 18 28 27 1 16 8 3 3 3 3 7 1 16 16 25 26 29 19 
19 18 24 16 2 2 1 16 1 2 1 2 2 1 1 8 3 3 3 3 7 1 2 2 16 2 16 2 1 23 18 18 28 27 1 16 1 8 3 4 5 5 15 16 1 16 16 2 23 19 
19 18 24 1 1 2 16 1 2 10 10 10 10 10 10 11 3 3 3 3 7 2 1 2 2 2 16 12 10 25 26 26 27 10 10 13 16 8 3 7 34 34 34 34 34 34 16 1 23 19 
19 18 24 2 16 1 10 10 11 3 3 3 3 3 3 3 3 3 3 3 7 1 12 10 10 10 10 11 3 3 3 3 3 3 3 9 13 8 3 7 34 1 1 35 1 34 16 16 23 19 
19 18 24 2 1 8 3 3 3 3 4 5 5 5 5 6 3 3 3 3 7 1 8 3 3 3 3 3 3 5 5 5 6 3 3 3 9 11 3 7 34 1 1 1 1 34 16 16 23 19 
19 18 24 2 1 11 3 4 5 5 15 2 2 1 1 1 5 5 5 5 15 1 1 5 5 5 5 5 5 20 21 22 14 6 3 3 3 3 3 7 34 34 34 1 1 34 1 2 23 19 
19 18 24 16 8 3 3 7 1 2 2 2 1 2 2 2 1 1 1 2 2 2 1 1 1 1 16 1 1 23 18 24 1 14 5 6 3 9 13 1 1 1 34 1 1 34 2 2 23 19 
19 18 24 2 8 3 4 15 1 16 1 2 2 2 16 1 1 2 1 2 2 2 2 1 1 16 1 1 1 23 19 24 1 1 1 8 3 3 7 34 34 34 34 1 34 34 2 2 23 19 
19 18 24 2 8 3 7 1 16 16 16 1 1 2 1 16 1 2 1 2 2 2 2 1 1 1 1 1 20 31 19 30 22 1 1 14 5 5 15 1 1 1 1 1 34 2 2 20 31 19 
19 18 24 16 8 3 7 16 16 16 20 22 1 16 1 16 1 1 1 2 2 2 2 2 1 1 1 1 23 19 19 19 30 22 1 1 34 1 1 34 34 34 34 34 34 2 2 23 18 19 
19 18 24 2 8 3 7 1 20 21 31 30 21 22 1 2 1 16 1 1 1 2 2 1 1 1 20 21 31 19 19 19 19 24 1 1 34 34 34 34 1 16 1 16 1 1 20 31 18 19 
19 18 24 2 8 3 7 1 23 19 19 19 19 30 21 22 1 1 1 1 1 1 1 1 20 21 31 19 19 19 19 19 19 30 22 1 1 1 1 1 16 1 16 16 1 20 31 18 19 19 
19 18 24 16 8 3 7 1 23 18 19 19 19 19 19 30 21 21 21 21 21 21 21 21 31 18 19 19 19 19 19 19 19 19 30 22 1 1 1 1 1 16 16 1 20 31 18 19 19 19 
19 18 24 2 8 3 7 1 23 18 19 19 19 19 19 18 19 19 18 19 19 19 19 19 19 19 19 19 19 19 18 19 19 19 19 30 21 21 21 21 21 21 21 21 31 19 19 19 19 19 
19 18 24 2 8 3 9 13 25 29 18 19 19 18 19 19 19 19 19 19 19 28 26 26 26 26 29 18 19 18 19 19 18 19 19 19 18 18 18 18 18 18 18 19 18 18 18 19 19 19 
19 18 24 16 8 3 3 7 1 25 26 26 26 26 26 29 19 19 19 19 18 24 3 3 3 3 23 18 19 19 19 19 19 19 18 19 19 19 19 19 19 19 19 19 28 26 26 29 19 19 
19 18 24 2 14 6 3 9 13 1 1 1 1 1 16 25 29 19 19 19 28 27 3 3 3 3 23 18 19 19 18 19 19 18 19 19 19 19 19 19 19 19 19 28 27 1 1 25 29 19 
19 18 30 22 1 8 3 3 9 10 10 10 10 13 2 1 23 19 18 28 27 3 3 3 37 3 23 19 19 19 28 26 26 29 18 19 19 19 19 19 19 19 18 24 1 16 16 1 23 19 
19 18 18 30 22 8 3 3 3 3 3 3 3 7 2 1 23 19 18 24 3 3 3 3 3 3 23 18 18 28 27 1 1 25 26 29 19 19 19 18 19 19 19 24 16 1 16 1 23 19 
19 18 18 18 24 1 5 5 5 5 5 6 3 7 1 16 23 19 19 24 3 3 3 3 3 20 31 18 28 27 1 1 1 1 1 25 29 19 19 19 18 19 18 24 1 1 37 16 23 19 
19 28 26 26 27 1 1 16 1 12 10 11 3 7 1 2 23 18 19 30 22 3 3 20 21 31 28 26 27 1 1 1 1 1 1 1 25 29 18 19 19 19 19 30 22 16 1 20 31 19 
19 24 16 16 16 16 16 16 2 8 3 3 3 7 1 2 23 18 19 18 30 21 21 31 18 28 27 1 1 1 1 34 34 34 34 34 1 25 29 18 19 19 19 19 30 21 21 31 18 19 
28 27 16 1 16 2 2 2 2 8 3 3 4 15 2 1 23 19 18 19 19 18 18 18 28 27 1 1 1 1 1 34 35 16 16 34 1 1 25 26 29 18 18 18 18 18 18 18 18 19 
24 2 1 2 16 2 1 16 16 14 5 5 15 1 1 20 31 19 19 19 19 19 18 28 27 1 1 1 1 1 1 34 1 1 16 34 1 1 1 1 25 29 18 18 18 18 18 18 18 19 
24 1 16 2 1 2 16 16 1 16 16 16 16 16 20 31 18 19 19 19 19 18 28 27 1 1 1 1 1 1 1 34 2 16 16 16 34 34 34 34 1 25 26 29 18 18 18 18 18 19 
24 2 16 16 16 2 16 2 2 16 2 16 1 20 31 19 19 19 19 19 19 28 27 1 1 1 1 1 1 1 1 34 1 1 1 16 16 16 33 34 1 1 1 25 26 29 18 18 18 19 
30 22 1 2 1 16 16 2 16 1 16 16 1 23 18 19 19 19 19 19 28 27 1 32 32 32 32 32 32 32 1 34 1 16 1 1 1 1 1 34 1 1 16 16 1 25 26 29 18 19 
19 24 2 1 2 16 2 2 2 36 2 1 20 31 18 19 19 19 18 28 27 1 1 32 16 16 33 16 16 32 1 34 16 16 16 16 1 1 2 34 16 1 16 2 1 16 1 25 29 19 
19 30 22 1 2 2 16 2 16 16 16 20 31 19 19 19 19 18 28 27 1 1 1 32 16 16 3 3 16 32 1 34 34 34 34 34 34 1 2 34 1 16 2 16 2 16 1 2 23 19 
19 18 30 22 1 2 1 2 16 16 20 31 18 19 19 19 18 28 27 32 32 32 32 32 16 3 3 3 16 32 1 2 2 16 1 1 34 2 1 34 2 2 16 16 2 1 2 1 23 19 
19 19 18 30 21 21 21 21 21 21 31 19 19 19 19 19 28 27 1 32 16 33 16 16 16 3 3 3 16 32 2 16 2 16 1 1 34 2 2 34 1 16 2 1 20 21 21 21 31 19 
19 19 19 19 19 19 19 19 19 19 18 18 19 19 18 28 27 1 1 32 16 3 3 3 3 3 3 16 3 32 1 12 10 10 10 10 10 10 10 13 1 1 20 21 31 18 19 19 18 19 
19 19 19 19 18 18 19 19 19 19 19 18 19 18 28 27 1 16 1 32 16 16 16 16 16 3 3 3 3 32 1 8 3 3 3 3 3 3 3 7 20 21 31 19 19 19 19 19 18 19 
19 19 18 28 26 26 29 18 18 19 19 18 19 18 24 1 16 2 2 32 32 32 32 32 32 32 32 3 3 32 1 8 3 3 3 3 3 3 3 7 23 19 19 18 19 19 19 19 19 19 
19 18 28 27 16 16 25 26 29 19 19 18 18 18 24 1 2 16 16 1 16 1 16 16 16 1 32 3 3 32 1 8 3 3 3 3 3 3 3 7 23 18 19 19 19 19 19 19 19 19 
19 28 27 16 16 16 16 16 23 19 19 19 19 18 24 1 1 1 1 16 1 12 10 10 10 10 10 3 3 10 10 11 3 3 3 3 3 3 3 7 25 18 18 19 18 19 19 19 18 19 
28 27 16 2 2 2 2 16 25 26 26 26 26 26 27 1 2 2 2 2 1 8 3 3 3 3 3 3 3 3 3 3 3 3 3 3 3 3 3 7 1 25 26 29 19 18 19 19 19 19 
24 2 16 2 16 16 2 2 8 3 3 3 3 3 3 7 1 1 1 1 1 8 3 3 3 3 3 3 3 3 3 3 3 3 3 3 3 3 3 7 1 16 1 23 18 18 19 19 19 19 
24 16 16 2 2 2 16 16 8 3 3 3 3 3 3 7 2 2 2 1 1 8 3 3 3 3 3 3 3 3 3 3 3 3 3 3 3 3 4 15 1 1 1 25 26 29 19 18 19 19 
24 16 16 16 16 2 16 16 2 20 21 21 21 21 22 1 16 1 1 2 2 8 3 3 3 3 3 3 3 3 3 3 3 3 3 3 3 4 1 16 16 16 2 1 2 25 29 19 19 19 
24 16 33 16 16 2 2 16 16 23 18 19 19 18 24 1 16 16 2 16 1 14 5 5 5 5 5 5 5 5 5 5 5 5 5 5 5 15 2 1 16 16 1 16 2 2 23 18 19 19 
24 16 2 2 16 16 2 2 16 25 29 19 19 19 30 22 1 16 1 16 16 1 16 16 16 1 1 1 20 21 21 21 21 21 21 21 21 22 1 16 1 2 2 33 16 2 23 18 19 19 
30 22 16 2 2 2 16 2 2 16 25 29 19 19 19 30 22 16 1 16 2 2 1 1 1 1 20 21 31 18 18 18 18 18 18 18 18 24 1 1 1 16 1 1 16 1 23 18 19 19 
19 30 21 22 16 2 2 16 2 2 16 25 26 29 19 19 30 22 1 16 16 16 16 1 20 21 31 18 18 18 19 18 19 19 18 18 18 30 21 22 1 1 16 1 16 20 31 19 19 19 
19 19 19 18 21 22 2 2 2 2 2 36 16 23 18 18 18 30 22 1 1 1 20 21 31 18 18 19 18 19 19 19 19 19 19 19 18 18 18 30 21 21 21 21 21 31 18 19 18 19 
19 18 19 18 19 30 21 21 21 21 21 21 21 31 18 18 18 18 30 21 21 21 31 18 18 18 19 19 19 19 19 19 19 19 19 19 19 18 18 18 18 18 18 18 18 18 18 18 18 19 
19 19 19 19 19 19 19 19 19 19 19 19 19 19 19 19 19 19 19 19 19 19 19 19 19 19 19 19 19 19 19 19 19 19 19 19 19 19 19 19 19 19 19 19 19 19 19 19 19 19 
